1111111111111111111111111
100000010000P000000000001
1C00100000000100000000001
1E00100000000100000000001
1111111111111111111111111